########  
#      #  
# $ $  #
#      ###
####$   @#
#..   .###
########