XXXXXXX
X     X
X @ *.X
X     X
XXXXXXX