##############
# @      #####  
# ! !  ###
#      ###
####$   ##
#..   .###
########